e1m3
17 17 1
Background
null 0 0 0 0 0 0 0
/---------------\
|               |
|               |
|               |
|        3__    |
|               |
|               |
|               |
|               |
|  /-\     /-\  |
|  |_|     |M|  |
|               |
|               |
| F     P     K |
|               |
|               |
\_______________/