testlevel
17 17 0
Background
ThotGeneral 5 5 5 150 10 2 100
|_______________|
|               |
|   |_____|     |
|   |     |     |
|   |__|  |     |
|   |__|  |     |
|         |     |
|         |     |
|     F   |     |
|         |     |
|         |     |
|  |  F   |     |
|  |      |     |
|  |  P   |     |
|  |______|     |
|               |
|_______________|